11111111111111111111111
1C01000C000C00000100111
10000111110000011110001
1P0C11E0000C01111100001
10000C00000111111101011
100000000C0001111110111
11111111111111111111111