1111111111111
1001000PE00C1
1111111111111