1111111111111
1001001C000C1
10C0001111101
1P0011E000001
1111111111111