1111111111111111
1C01000C000C0001
1000011111000001
1P0C11E0000C0001
10000C0000000001
100000000C000001
1111111111111111