11111111111111111111111
1C010000000000000100111
10000111110000011110001
1P001100000000111110001
10000000000111111101011
100000000000E1111110111
11111111111111111111111