1111111111111
1E01000000001
11C1111111111
1P00100100001
1111111111111