11111111111111111111111
11111111111111111111111
1011000000000C000100111
1E000111110000011110001
1000110000P000111110001
10C0000C010111111010111
10000000001001111110111
11111111111111111111111
11111111111111111111111
11111111111111111111111