1111111111111111111111111111111111111111111111
1P0000000C000000000000000C00000000000000000001
1000000110011110001110110001011111011110111101
10000011100100100001001100C10101010100101001C1
1000011010000010000100101001000100010010100101
1000110010011110000100101001000100011110111101
10011000100100000001001001C100010001100C100101
1011111111010010000100100101000100010100100101
1000000010011110101110100011001110010010100101
1000000000000000000000C00000000000000000000001
1C00110001111101111101111000100010100010111101
1001010001000101000101001000100100100010100101
1010010000000100000100001C00101000100010100101
1C00010000111100111100C01000110000111110111101
1000010000000100000100001000101000100010110C01
1000010001000101000100001000100100100010101001
1001111101111101111100001010100010100010100101
100000C0000000000000000000000000000000000000E1
1111111111111111111111111111111111111111111111